*************************
* *     *     *        O*
* * *** * * * * *** *** *
* *   *   * * *   *   * *
* *** ***** * * ***** ***
* *       * * * *   *   *
* * ******* * * * * * * *
*   *       * * * * * * *
* *** ******* *** * *** *
* * * *     *     *     *
* * * ***** *********** *
*   *     *       *   * *
******* * * *** * * * * *
*     * * * * * * * *   *
***** *** * * * *** *****
*   *     *   *     *   *
* * ********* ******* * *
* *     *   *   * *   * *
*** *** *** *** * * *** *
*   *       *   *     * *
* * ********* *** ***** *
* * *   *   *   *   *   *
* *** * * * *** ***** * *
*P    *   *           * *
*************************